5 5
-----------
|  @   X  |
|&   W    |
|  X   T  |
|= =      |
|K   * M  |
-----------