6 6
-------------
|* @ W X   &|
|& * !       |
|  X   T   %|
|= = * X X $|
|K #   M   $|
-------------