6 6
-------------
|  @ W X   &|
|& *        |
|  X   T   %|
|= =     X $|
|K   * X M  |
-------------