6 6
-------------
|  @   X    |
|& * W      |
|  X   T    |
|= =     X  |
|K   * X M  |
-------------