9 9
-------------------
|W     %   X      |
|                 |
|      #   $      |
|    # @ #     &  |
|      #          |
|  &     &        |
|= = =           !|
|K   *         ! M|
|  T *   X       !|
-------------------