5 9
------------------
|  !   T       * K|
|X             * *|
|      M   &      |
|# #              |
|@ #   &   X   W  |
------------------